1 13 31
%%%%%%%%%%%%%%%%%%%%%%%%%%%%%%%
%p                            %
% # # # # # # # # # # # # # # %
%                             %
% # ##### ##### #   # ##### # %
%      #  #     ##  # #       %
% #   #   ##### # # # # ### # %
%    #    #     #  ## #   #   %
% # ##### ##### #   # ##### # %
%                             %
% # # # # # # # # # # # # # # %
%p                            %
%%%%%%%%%%%%%%%%%%%%%%%%%%%%%%%