2 13 31
%%%%%%%%%%%%%%%%%%%%%%%%%%%%%%%
%p * *2       *f ** * *      p%
% # # # #*# # #*# # # # # #*# %
%    * * *** **      *    **  %
% #*# # # # #1# #b#1# # # # #*%
%   *      *     **      *  **%
% # #*#*# # # # #*#*#*#*# # # %
%   *  2     *   * *x* *      %
% # # # #*# # # # # # #*# #*# %
%   ****         *1           %
% # # # # # # # # #*# # # # #*%
%p ** *   *    5        2    p%
%%%%%%%%%%%%%%%%%%%%%%%%%%%%%%%