2 13 31
%%%%%%%%%%%%%%%%%%%%%%%%%%%%%%%
%p * *2       *f ** * *    * p%
% # # # #*# # #*# # # # # #*# %
%    * * *** **      *    **  %
% #*# # # # #1# #b#1# # # # #*%
%   *      *     **      *  **%
% # #*#*# # # # #*#*#*#*# # # %
%   *  2         * *x* *      %
% # # # #*# # # # # # #*# #*# %
%   *s**         *1           %
%   # # # # # # # #*# # # # #*%
%p ** *   *    3        2 *  p%
%%%%%%%%%%%%%%%%%%%%%%%%%%%%%%%